#!/bin/bash
###############################################################################
#
# Name: .bash_aliases
# Author: Travis Goldie
# Date: January 2012
# Purpose: Aliases for the bash terminal
#
###############################################################################
#-------------------------------------------------------------
# Aliases
#-------------------------------------------------------------
# ls aliases
alias ls="ls --color=auto"
alias lsa="ls -lhA --color=auto"
alias lsd="ls -lda --color=auto */"
alias lsf="ls -lhA --color=auto | grep -v ^d"
alias lsl="ls -lh --color=auto"
alias dir="ls -lad */"
alias lsv="ls --color=auto --format=vertical"
alias lrgfile="ls -lSrh"

# cd aliases
alias cd..="cd .."
alias cdl="cd .. ; ls -lhA --color=auto"

# Text/history aliases
# Lines counts the number of lines in a file
alias wcl="wc -l"
alias h="history"
alias m="more"
alias l="less"

# System functions
alias clrswap="echo 'Turing swap off' ; sudo swapoff -a && echo 'Turning swap back on' && sudo swapon -a"
alias please="sudo"
alias src="source ~/.bashrc ~/.inputrc ~/.profile"

# grep functions
alias grep="grep --color=auto "
alias grepn="grep -n"
alias fgrep="fgrep --color=auto"
alias egrep="egrep --color=auto"

# grep ps with headers
alias psgr="ps -F | head -n1 ; ps -eF | grep"
alias psgrp="psgr"

# SSH aliases
alias sshi="ssh beeryard@integritypropsc.com"
alias sshfsm4="sshfs root@minion4.sc.steeleye.com:/var/lib/tomcat7/webapps/ui /export/minion4/"

# Program file commands
alias chrome="google-chrome"
alias etagsbck="etags -f $VIMBACKUP/TAGS * && chmodx $VIMBACKUP/TAGS"
alias svim="sudo vim -p"
alias vimp="vim --noplugin"
alias view="view -p"
alias vimsrc="vim -S $VIMBACKUP/src.vim"
alias tabdiff="vim -c 'silent :TabDiff'"

alias shrew="sudo iked & disown && qikea > /tmp/qikea.log"
alias ike="shrew"

alias pushit="$HOME/ui/utils/push.sh -b minion4"
alias updateit="$HOME/ui/utils/update.sh minion4"

# Use Readline wrapper with these programs
alias cpan="sudo rlwrap cpan"
alias kp="rlwrap kpcli --kdb=$DROPBOX/APG/KeePass.kdbx"
alias sqlite="rlwrap ~/bin/sqlite3"

# NodeJs module REPL"s
alias node="rlwrap node"
alias node="rlwrap nodejs"
alias protractor-repl="rlwrap protractor-repl"
alias phantomjs="rlwrap phantomjs"

# Lets play Nethack Online!
#alias nethack='telnet nethack.alt.org'
alias crawl="ssh joshua@crawl.akrasiac.org" # pwd: joshua
alias nethack="ssh nethack43@nethack4.org"  # pwd: nethack43

# Apt-Get and dpkg alias
alias aptget="sudo apt-get install"
alias aptgeta="sudo apt-get autoremove"
alias aptgetf="sudo apt-get -f install"
alias aptgetr="sudo apt-get remove"
alias aptgetu="sudo apt-get update"
alias aptgetU="sudo apt-get dist-upgrade -y"
alias aptkey="sudo apt-key adv --recv-keys --keyserver keyserver.ubuntu.com"
alias aptsearch="sudo apt-cache search"
alias ppa="sudo apt-add-repository"
alias dpkgi="sudo dpkg -i"

# File Permissions
# Adds exucution to the owner's (user's) permissions
alias chmodx="chmod -Rv u+x"

# Test for long running processes
alias alert='notify-send --urgency=low -i "$([ $? = 0 ] && echo terminal || echo error)" "$(history|tail -n1|sed -e '\''s/^\s*[0-9]\+\s*//;s/[;&|]\s*alert$//'\'')"'
